推,噓,分數,作者,標題,時間
11,2,9,hahaha021225 (安安你好),[問卦] 除濕機除濕時，人可以在旁邊嗎？,Sat May 30 02:56:29 2020
2,0,2,abcgo (真冷的冬天),[問卦] 關於農業我們知道嗎？,Sat May 30 07:59:58 2020
0,0,0,derekhsu (華麗的天下無雙),[爆卦] 全球病例增速擴大破600萬，緩解跡象出現,Sat May 30 11:04:34 2020
7,2,5,playla (比較愛),[問卦] 番茄醬是什麼鬼東西,Sat May 30 07:42:30 2020
3,3,0,love1500274 (CoWuCoWu),[問卦] 很多人看文章484只看標題不看內文,Sat May 30 07:06:14 2020
26,2,24,CavendishJr (伊井野梅西子),[問卦] 美洲獅梅西舒服的生活><,Sat May 30 07:07:25 2020
68,5,63,gay731 (G少),[新聞] 通姦罪掰了！網紅律師曝「6種人受益最大,Sat May 30 09:16:23 2020
0,0,0,Punchline (哏),[問卦] rapper除了阿姆其他都垃圾吧？,Sat May 30 11:07:17 2020
9,5,4,Beanoodle (津崎似超人平匡先生),[問卦] 沒看過想見你怎麼跟女生有話題？,Sat May 30 05:18:20 2020
4,1,3,gracew0709 (succinyl choline),[問卦] 割蛋蛋為什麼不算侵犯器官權,Sat May 30 02:57:09 2020
34,1,33,Taiwanese (臺灣人),[問卦] 大直是不是很多有錢人阿,Sat May 30 09:20:43 2020
14,1,13,MeiHS (囧),[問卦] 北海道最強最推的拉麵湯頭是哪一個勒？,Sat May 30 01:35:50 2020
0,0,0,minthan (天映藍小可),[問卦] 按讚之後多久可以再按讚一次,Sat May 30 11:10:09 2020
6,1,5,typeklng (  ),[爆卦] BlackLivesMatters,Sat May 30 10:03:42 2020
8,1,7,hk416 (☑☠☜✉☎♂♀♪嫑嫑的),Re,Sat May 30 02:09:59 2020
19,6,13,hoanbeh (初入江湖淨添堵),Re,Sat May 30 07:29:51 2020
10,1,9,homerun2005 (ほめる),[問卦] 到底韭菜為啥不介意貧富不均？,Sat May 30 10:05:00 2020
8,0,8,koheik2 (ko),[問卦] 想領紓困+失業補助 選甚麼工作好?,Sat May 30 01:56:02 2020
8,17,-9,Adelaide66 (baby66),[新聞] 鄉民女神懷孕突聞到檀香味 宮廟男星現身,Sat May 30 09:07:14 2020
2,0,2,loser1 (拍嘎爪得白醬),Re,Sat May 30 02:08:55 2020
5,2,3,teeheehee (軟尾拋拋翔(′・ω・`)),[問卦] 異形電影哪一部最糞？,Sat May 30 01:02:41 2020
1,0,1,akanishiking (arnold jackson),[問卦] Yellow Lives會被重視嗎？,Sat May 30 10:39:19 2020
5,4,1,hika1234 (魚飄飄),Re,Sat May 30 03:13:02 2020
24,6,18,notfound0506 (存在の証明),[問卦] 文筆很好可以幹嘛,Sat May 30 03:35:19 2020
2,3,-1,funsky (小妹笑嘻嘻OuO),[問卦] 好樂迪484盤子去的地方啊,Sat May 30 02:24:34 2020
7,7,0,Nigger5566 (尼哥56),[問卦] 獵人選舉篇是不是過譽了,Sat May 30 02:44:12 2020
17,0,17,tennoji2003 (),[問卦] 台北人到南部最難適應的是什麼？,Sat May 30 00:53:21 2020
19,2,17,wang1b (唯i廢文<3),[問卦] 素食者的寵物也會吃素嗎,Sat May 30 10:19:19 2020
14,0,14,randy211161 (一生只愛みおな♡),Re,Sat May 30 01:28:50 2020
18,9,9,Eliphalet (高等遊民),[新聞] 性侵女兒15年多次「逼墮胎」！獸父還錄影,Sat May 30 08:23:38 2020
9,1,8,leo1990910 (魯刺客 Leo l'assassino),[問卦] 下禮拜去高雄擺攤賣什麼會賺？,Sat May 30 09:03:47 2020
4,2,2,CYKONGG (XXX),[新聞] 抓猴和蒐證價差7、8倍 徵信業憂收入銳減,Sat May 30 02:32:37 2020
7,1,6,nodnarb1027 (珍珠鮮奶綠),[問卦] 南庄跟內灣哪個好玩,Sat May 30 10:43:06 2020
7,10,-3,kiwidoit (台巴子想吃飛彈),[問卦] 是不是可以開始光明正大幹別人老婆了:)??,Sat May 30 02:51:06 2020
5,0,5,spector66 (天氣預報),Re,Sat May 30 10:45:32 2020
12,9,3,Dinenger (低能兒),Re,Sat May 30 01:28:06 2020
23,7,16,KennethC (Smith),[新聞] 高市府有意接手中海艦 海軍：已暫緩與得,Sat May 30 00:55:28 2020
3,0,3,pochunlinn (BJLIN),[問卦] 校歌都是那麼難聽的嗎？,Sat May 30 02:00:12 2020
0,0,0,howard0113 (無敵係邊),Re,Sat May 30 04:33:46 2020
328,25,303,Workforme (′‧ω‧‵),[新聞] 制裁中國 美取消香港特殊待遇並退出世衛,Sat May 30 05:14:45 2020
53,5,48,cleversun (bubu大),[問卦] 覺得頂大學生死讀書的說法到底哪來的,Sat May 30 01:09:30 2020
2,0,2,xzcb2008 (卍情色日本喵喵卍),[問卦] 記帳的有那麼難嗎？,Sat May 30 10:44:22 2020
1,20,-19,KINMENKING (亂世狂刀),Re,Sat May 30 00:54:47 2020
14,5,9,TyuzuChou (子瑜我老婆),[新聞] 國健署修菸害防制法 電子煙、加味菸將禁,Sat May 30 05:53:07 2020
14,2,12,TwiEnable (HorseFucker),[問卦] 現在改報紙頭條還來的及嗎？,Sat May 30 04:03:42 2020
15,1,14,zntozteent (百香綠加椰果),[問卦] 會先擦鼻涕還是眼淚,Sat May 30 05:24:32 2020
17,1,16,aigame (neko),[新聞] 通姦罪違憲 3男2女受惠 今晚就出獄,Sat May 30 00:57:14 2020
18,65,-47,a10141013 (FlyBall),[新聞] 兩岸定海神針 九二共識回來了,Sat May 30 10:02:23 2020
11,3,8,s327 (PrototypeDesigner),[問卦] 為什麼Google不建立專屬生物組織 病毒or細胞搜尋引擎?,Sat May 30 07:24:12 2020
0,0,0,NewEG (NewEG),[新聞] 陸稱反分裂法 絕非稻草人,Sat May 30 11:04:09 2020
5,0,5,kingfsg7326 (認 同 請 按 2 ),[問卦] 對PTT最有印象的事件是什麼？,Sat May 30 09:41:06 2020
22,21,1,chot (C-hot),[問卦] 台灣害了香港？？,Sat May 30 09:47:24 2020
10,1,9,Kimmy (Kimi),[問卦] 有鄉民想繼承番墮羅拳嗎？,Sat May 30 09:33:40 2020
10,4,6,t00012 (第六天蛇王),[問卦] 如何搭訕隔壁的太太,Sat May 30 09:08:06 2020
20,4,16,Lampaininder ( ),[新聞] 為領急難紓困金 竟暫停勞保,Sat May 30 09:07:56 2020
8,0,8,lalalamb (lala),[問卦] 通姦除罪化是不是影響不大?,Sat May 30 10:37:11 2020
10,3,7,losh (007),[問卦] 假如中國現在支持美國黑人人權會怎樣,Sat May 30 04:20:54 2020
69,6,63,whiteadam (blue eyes blue),[問卦] 鄭伊健是最帥的香港男明星嗎?,Sat May 30 01:52:10 2020
4,1,3,lianpig5566 (家庭教師殺手里包恩),[問卦] 不會翻身的蟲在想什麼,Sat May 30 11:10:06 2020
1,0,1,autechre (Untilted),Re,Sat May 30 07:13:10 2020
56,6,50,bubu26 (白寶),[問卦] 那種人妻進職場一樣非常受大家歡迎,Sat May 30 08:33:37 2020
7,1,6,lovekimbum (千山暮雪 隻影向誰去),[問卦] 雙主修課表怎麼辦到的阿?,Sat May 30 02:36:47 2020
29,3,26,jiangjiang33 (yo man),[新聞] 17歲少女和20歲情郎私奔！遭16男當眾扒衣,Sat May 30 01:15:20 2020
3,4,-1,parttime (PTrrr),[問卦] 通姦除罪後要怎麼抓姦在床？,Sat May 30 10:57:33 2020
10,0,10,ryusenming (射出來...就沒事了),[問卦] 會常常看自己的存款嗎?,Sat May 30 10:02:40 2020
6,2,4,ketter (挖西林老背),[問卦] 哪一艘船可以打贏航母？,Sat May 30 10:56:48 2020
2,3,-1,antonysole (辰辰),Re,Sat May 30 10:50:39 2020
13,8,5,iamgaylan (),[問卦] 台女：反通姦除罪=沒自信=矮窮挫,Sat May 30 02:36:50 2020
42,9,33,zakijudelo (柴克豬大佬),[問卦] 中共在香港舞劍，卻是劍指台灣嗎？,Sat May 30 10:27:20 2020
5,0,5,RLAPH (川尻浩作),Re,Sat May 30 05:40:41 2020
130,35,95,nasha2 (蝴蝶效應 六度分隔理論),[新聞] 通姦罪違憲》大法官吳陳鐶 唯一提出不同,Sat May 30 02:02:48 2020
1,0,1,DMGA (DMGA),[問卦] 是痛苦造就了我們嗎？,Sat May 30 04:24:31 2020
5,0,5,gk1329 (),Re,Sat May 30 10:45:22 2020
15,8,7,sabrina1113 (1017),Re,Sat May 30 03:27:36 2020
6,0,6,hmenri (),[問卦] 和美鎮柑井里電信基地台有後續嗎,Sat May 30 10:10:50 2020
3,1,2,SkyPlus (Sky),Re,Sat May 30 09:36:11 2020
4,2,2,end56 (終結56),[問卦] 被學生綁在校門的八卦,Sat May 30 07:10:02 2020
5,2,3,goldsingle (BE A FULLSER),Re,Sat May 30 09:52:21 2020
0,0,0,kingfsg7326 (認 同 請 按 2 ),[新聞] 中共人大通過港版國安法草案 賴清德：,Sat May 30 11:08:54 2020
1,1,0,dangerousair (balabababa),[問卦] 這是什麼蟲蟲啊,Sat May 30 09:58:08 2020
11,1,10,a1234555 (阿姆姆最乖最棒最可愛),[問卦] 台灣的通姦跟國外哪裡不一樣阿,Sat May 30 02:42:39 2020
21,10,11,SammySosa (我沒用禁藥),[問卦] 有沒有女人樣貌(以卡卡兒為例)千變萬化的八卦?,Sat May 30 02:16:48 2020
2,4,-2,Dinenger (低能兒),Re,Sat May 30 01:03:20 2020
8,2,6,k321045 (蒜泥厲害),[問卦] 晚上公園有點陰森是正常的嗎,Sat May 30 01:13:48 2020
6,5,1,Willis5566 ((〃∀〃)),[問卦] 把偽娘灌醉有機會%%嗎？,Sat May 30 01:26:28 2020
8,0,8,LaAc (深淵戰士),[問卦] 為什麼技職體系在高教會跟普大混在一起,Sat May 30 08:22:21 2020
0,2,-2,k90209 (k90209),[問卦] 機車行的阿弟仔是不是普遍滿帥的,Sat May 30 10:59:51 2020
2,6,-4,z842657913 (小鈞),[問卦] 腋下控進來一下,Sat May 30 02:00:56 2020
36,4,32,lelena (馬利克),"[問卦] 香港不再高收入,房價是否崩盤的八卦?",Sat May 30 08:09:55 2020
4,13,-9,King5566 (小兔子暗黑無限破),[問卦] 欸 還沒睡的肥宅過來一下,Sat May 30 02:33:25 2020
11,0,11,LAPDSWAT456 (胖達稱霸地球),[問卦] 美國是不是想把尼哥國甩給支那？,Sat May 30 07:46:30 2020
1,4,-3,iComeInPeace (匹——嘶！),[問卦] 賴床賴要1小時有多強,Sat May 30 09:02:16 2020
17,11,6,secretfly (☠鬼滅·     之喵喵),[問卦] 朋友在ig上po說背肌太小？？,Sat May 30 01:13:07 2020
51,11,40,geordie (Geordie),[新聞] 北京再發對台武力威脅五角大樓官員：有,Sat May 30 07:23:14 2020
0,0,0,dan1994112 (基隆吳彥祖),[問卦] 還記得躺著玩坐著玩趴著玩的都幾歲了,Sat May 30 11:06:45 2020
34,2,32,pp771017 (橫艾),[問卦] 卜學亮的代表作是什麼？,Sat May 30 07:19:51 2020
6,1,5,HumphreyShih (Stone),[問卦] 通姦民法可以只對小三求償?,Sat May 30 10:01:30 2020
11,1,10,zxc17893 (八千代代木村拓哉),[問卦] 為什麼3D列印公仔比不上翻模精美？,Sat May 30 02:51:53 2020
8,15,-7,blueadam193 (),[新聞] 「校長醉倒」照被爆是變造 議員：網友太厲害了但確有其事,Sat May 30 08:59:25 2020
11,2,9,tom501062003 (池袋情報商),[問卦] 馬國保打得贏有在練的大學生嗎？,Sat May 30 08:38:05 2020
1,0,1,Lailungsheng (狼不會入眠),Re,Sat May 30 09:50:59 2020
7,2,5,prmea (123),[問卦] 那為什麼還有墮胎罪？,Sat May 30 08:01:01 2020
9,6,3,relax911 (Lmerro),[新聞] 通姦除罪／通姦罪失效 若配偶外遇仍可要,Sat May 30 08:24:10 2020
0,0,0,junter1989k (軍特),Re,Sat May 30 02:36:46 2020
6,2,4,autokey (該起床啦),[問卦] 3個女孩與1個男孩可以組成幾個小團體,Sat May 30 07:37:36 2020
12,7,5,a77774444 (我愛ˋ台灣),[問卦] 台灣司法凌駕各權的八卦？,Sat May 30 01:03:46 2020
16,2,14,samman0917 (台中打網球),Re,Sat May 30 09:03:43 2020
13,8,5,zzzz8931 (宅男),[新聞] 撤換2反同委員有難度　柯市府：要證明,Sat May 30 10:00:58 2020
8,2,6,su27 (su27),Re,Sat May 30 07:35:10 2020
5,3,2,pardo (pardo),[問卦] 在飛機上po文的話IP是屬於哪個國家的,Sat May 30 03:17:45 2020
0,0,0,kenting123 (Ken),[問卦] 台女最大的競爭對手是誰,Sat May 30 11:06:11 2020
5,5,0,lalalamb (lala),[新聞] 通姦罪違憲失效！員警樂見不用再撿保險套,Sat May 30 10:50:54 2020
4,1,3,xpsecret (雙層純牛肉),[問卦] 拿真錢玩大富翁算是財富自由嗎,Sat May 30 06:59:48 2020
0,0,0,chen5566 (文心),[問卦] 古代有反織田信長的嗎？,Sat May 30 11:09:48 2020
11,0,11,ray90910 (Blackbird),[問卦] 佐佐木希怎麼能一直這麼正？,Sat May 30 00:51:44 2020
3,2,1,ocean92 (海),[問卦] 惡魔符號666為什麼還要辦活動 宅在家ok？,Sat May 30 08:45:41 2020
325,17,308,Mariano42 (Mariano Rivera),[爆卦] CNN總部被黑人暴民砸毀啦!,Sat May 30 09:41:16 2020
4,0,4,yafx4200p (是該下凡渡劫了),Re,Sat May 30 07:55:59 2020
3,8,-5,popy8789 (面對它),[問卦] 長輩有催婚壓力可以說通姦除罪不想找嗎？,Sat May 30 00:49:20 2020
2,0,2,AngryYouth (森寶 420friendly),Re,Sat May 30 06:13:40 2020
3,1,2,mshuang (竹碳烏龍),Re,Sat May 30 06:19:30 2020
39,12,27,poi96300 (天阿poi),[問卦] Google還要統一多少東西？,Sat May 30 09:24:10 2020
7,0,7,Bainite (黑羽毛 ┐(′д`)┌),[問卦] 宵夜吃這樣合格了ㄅ,Sat May 30 00:58:52 2020
2,1,1,honkwun (反皮草 拒絕血腥時尚),[新聞] 核災後日本中斷鐵道再開 JR員工憂輻射被,Sat May 30 09:20:02 2020
7,3,4,afflic (afflic),Re,Sat May 30 04:12:45 2020
381,16,365,jimmy5680 (If Penguins May Fly),[爆卦] 川普：美國將取消香港特殊待遇,Sat May 30 03:25:09 2020
9,2,7,moonblacktea (張阿月紅茶冰),Re,Sat May 30 08:57:42 2020
3,0,3,xoxxo (xoxxo),Re,Sat May 30 02:00:19 2020
8,0,8,blargelp (bernie識形態),[問卦] 中國到底贏得了多少東西,Sat May 30 09:44:28 2020
29,2,27,alicevvn (阿利系委委恩),Re,Sat May 30 02:22:27 2020
6,0,6,genheit (genheit),[問卦] 妻不如妾，妾不如妓，妓不如偷，偷…,Sat May 30 03:29:24 2020
7,1,6,mongi (大體老屍),[新聞] 爆染病墮胎遭網酸鮑鮑換包包 亞洲波神,Sat May 30 10:02:21 2020
0,0,0,pujos (lks),Re,Sat May 30 11:04:18 2020
3,4,-1,ShenVen5566 (三代自耕農),[問卦] 置板凳！ 我有說「好」嗎？ 上一動,Sat May 30 02:07:08 2020
29,1,28,m0ark121 (ALICE),[新聞] 快訊／川普宣布「終止與WHO關係」將取消,Sat May 30 03:26:07 2020
3,5,-2,zzyyxx77 (討噓大師77),[問卦] 明天想借老北的車開？,Sat May 30 02:51:18 2020
5,2,3,cwh0105 (Ex咖哩棒),[問卦] 女友接了社長要跟我分手怎麼辦?,Sat May 30 00:51:46 2020
1,2,-1,spector66 (天氣預報),[新聞] 中央有溝通振興券政策？黃珊珊：北市府和,Sat May 30 09:55:53 2020
4,0,4,todao (心裡有數),Re,Sat May 30 06:26:03 2020
21,5,16,minami77 (南),[問卦] 川普講完甩頭就走代表什麼?,Sat May 30 08:20:12 2020
3,11,-8,wakaura (wakaura),[問卦] 女生一大早穿黑絲不會涼嗎？,Sat May 30 08:49:00 2020
12,0,12,CavendishJr (伊井野梅西子),[新聞] 西班牙批准窮人最低收入補貼計畫 每人每,Sat May 30 08:09:33 2020
6,1,5,Rin5566 (派屈克),[問卦] 有沒有大雨的八卦？,Sat May 30 04:09:12 2020
7,5,2,ss8901233 (不聽不聽你別說),[問卦] 求推薦cp值高的藍芽運動耳機,Sat May 30 03:02:34 2020
4,1,3,kilva (嗡嗡),[問卦] 侵權行為與刑責間的關係,Sat May 30 07:56:43 2020
10,2,8,ggian123 (小孩當國文老師打斷他腿),[問卦] 川普現在是不是很爽,Sat May 30 10:08:11 2020
24,33,-9,DDDDRR (QQ),[新聞] 米砂拋震撼彈「我進軍A片圈了」！　已拍5,Sat May 30 09:32:10 2020
7,0,7,nawabonga (vista不到三年就玩完),[問卦] 台灣怎麼那麼多奇奇怪怪的聯盟,Sat May 30 10:51:31 2020
5,0,5,petfat918 (阿肥),Re,Sat May 30 10:15:59 2020
2,1,1,gay731 (G少),[問卦] 寒風吹起 細雨迷離 風雨揭開我的記憶,Sat May 30 09:24:44 2020
48,2,46,cosmite (焼き団子),[問卦] 驚！企鵝是鳥類 有不能飛的鳥？,Sat May 30 09:02:01 2020
59,4,55,guohuo (帕羅奧圖馬克祖克伯),[問卦] 帳號whale666在蝦皮賣ptt代發文的卦?,Sat May 30 04:14:09 2020
9,1,8,IamCuteGirl (CuteGirl5566),[問卦] 有生之年能看到中國被肛嗎？,Sat May 30 04:01:12 2020
54,2,52,LukeSkywaker (路克天醒者),[爆卦] SpaceX starship SN4 爆炸啦,Sat May 30 03:26:30 2020
8,10,-2,Heedictator (希澈),[問卦] 泱泱是不是屌打一堆台男？,Sat May 30 02:50:05 2020
10,1,9,whiteadam (blue eyes blue),[問卦] 電音歌曲有超越眉飛色舞的嗎?,Sat May 30 01:44:07 2020
5,3,2,A816 (♥七瀬丸的灰太狼♥),[問卦] 收到69元紅包代表什麼？,Sat May 30 08:12:15 2020
11,21,-10,Wardyal (Wardyal),[問卦] 假如你是特朗普你會怎麼做？,Sat May 30 11:00:30 2020
2,12,-10,Soros79 (井底蛙),[問卦]港台覺青是否應該支持美國示威者,Sat May 30 03:22:35 2020
10,0,10,ikai99 (18歲的天空),Re,Sat May 30 02:16:35 2020
0,0,0,hika1234 (魚飄飄),Re,Sat May 30 09:57:11 2020
8,4,4,LEEJINQYEU (不專業貓奴),[問卦] 有沒有雲米洗衣機出貨問題的八卦？,Sat May 30 02:31:44 2020
3,1,2,downstairs (樓下),[問卦] 肥宅做自己有加分嗎？,Sat May 30 09:55:23 2020
3,4,-1,JRSmith (肥宅編號7414),[問卦] 通姦除罪跟肥宅有什麼關係？,Sat May 30 02:39:19 2020
4,4,0,autokey (該起床啦),[問卦] 護理師班表的C班要做啥的八卦？,Sat May 30 03:37:53 2020
6,3,3,Ahhhhaaaa (果汁棒),Re,Sat May 30 00:46:23 2020
1,2,-1,a58524andy (a58524andy),[問卦] 我會不會又睡到下午了,Sat May 30 10:41:58 2020
7,4,3,Dinenger (低能兒),[問卦] 請問現在是開啟了大約跑時代了嗎？,Sat May 30 00:54:37 2020
6,7,-1,a22298811 (鐵達尼號),[問卦] 去參加客家婚禮喜糖不能抓一把的八卦,Sat May 30 00:50:47 2020
6,21,-15,abc0312 (ABC),Re,Sat May 30 07:36:55 2020
3,8,-5,fantasibear (布穀熊),[問卦] 玖壹壹的失敗是不是不會唱饒舌？,Sat May 30 02:31:12 2020
4,2,2,piggy37 (小時),[問卦] 沒有人民幣是不是很恐怖,Sat May 30 09:45:16 2020
4,3,1,Dinenger (低能兒),Re,Sat May 30 02:43:30 2020
16,19,-3,takashi01 (廢文小王子),[問卦] 林弈含是誣告始祖嗎？,Sat May 30 03:33:04 2020
5,0,5,Ahhhhaaaa (果汁棒),Re,Sat May 30 03:57:47 2020
2,3,-1,crazystyle63 (中二的逆襲),[問卦] 幾點算太早，有迷有卦？,Sat May 30 10:57:51 2020
1,6,-5,twuuu (uuu),Re,Sat May 30 01:49:16 2020
5,0,5,wacer8486 (我有雞雞),[問卦] 在美國的黑人警察怎麼辦?,Sat May 30 10:53:59 2020
8,3,5,parttime (PTrrr),Re,Sat May 30 10:37:01 2020
10,2,8,spector66 (天氣預報),Re,Sat May 30 10:10:58 2020
4,2,2,Limitskyz (羅百告),[問卦] 有沒有蚊子沒腹部還可以活的掛,Sat May 30 06:16:21 2020
7,1,6,ph777 (松山韋禮安),[問卦] 台北市可舉辦室外運動會？,Sat May 30 08:40:33 2020
3,3,0,homerun2005 (ほめる),Re,Sat May 30 08:48:04 2020
12,16,-4,dog990999 (姆咪心動動),[新聞] 韓國瑜要市府學中國「溫暖的服務」 鄭照,Sat May 30 00:44:56 2020
5,1,4,copylong20 (卡比長),Re,Sat May 30 08:58:35 2020
17,4,13,gigikaka (Head to head),[問卦] 中國共產黨可信度多高？,Sat May 30 10:08:30 2020
0,0,0,Ifault (Not my fault),[問卦] 會有吃到飽只有一個客人的嗎？,Sat May 30 11:07:55 2020
2,0,2,B9830226 (czcchi),[問卦] 虎王為何美國人只敢罵卡羅,Sat May 30 10:52:05 2020
11,0,11,teeheehee (軟尾拋拋翔(′・ω・`)),[問卦] 哪首歌可以當地球的「球歌」來代表人類？,Sat May 30 09:42:37 2020
29,20,9,Amygo (心在何方),[問卦] 撐香港怎麼香港更慘了？,Sat May 30 09:40:51 2020
3,1,2,science9686 (科學 = 真理),[新聞] HTC VIVE 助攻消防員培訓再升級,Sat May 30 09:07:21 2020
4,3,1,d995511 (flcl),[問卦] 人身上毛越多越是原始麻？？,Sat May 30 10:20:11 2020
4,0,4,Phimosis373 (兄ㄉㄟˇ先來碗大食客),[問卦] 美少女萬華鏡完結了..,Sat May 30 10:44:52 2020
5,3,2,SigmundFreud (西格蒙德．佛洛伊德),Re,Sat May 30 08:08:21 2020
40,24,16,ivorysoap (ivorysoap),[問卦] 香港人知道香港人的形象在華人圈不好嗎?,Sat May 30 09:57:32 2020
14,2,12,odd5566 (歐底迪),[問卦] 一大早就想做愛怎麼辦?,Sat May 30 06:00:18 2020
2,0,2,OfficeGL (妤欣),[問卦] 有金正恩的八卦嗎,Sat May 30 10:36:28 2020
10,2,8,bowenhp1234 (深夜美食家),[問卦] 被隔夜的奶油沾到會怎樣？,Sat May 30 10:24:30 2020
4,0,4,Nodens (大車駕訓班 榮譽教練),[問卦] 年輕人買不起房 多的錢要幹麻？,Sat May 30 02:36:39 2020
0,0,0,STAV72 (刁民黨黨務主委),[爆卦] 宜城市臺商翻牆求救，要救嗎？,Sat May 30 11:05:06 2020
8,2,6,stw0975 (      ),[新聞] 遭周玉蔻稱為頂新「門神」　羅智強求償千,Sat May 30 10:39:49 2020
105,24,81,akway (生活就是要快樂),[新聞] 14億元改建 大龍國宅竟是漏水屋,Sat May 30 09:46:38 2020
24,11,13,jajujo (尚未通過認證),[問卦] 為什麼美國這麼沒有國際觀,Sat May 30 05:07:32 2020
4,2,2,email9527 (想也知道),[問卦] 通姦民事要賠多少才合理,Sat May 30 10:53:28 2020
28,9,19,skn60694 (入聲),[新聞] 呂忠吉辦趴判賠717萬…400多人「百億求償,Sat May 30 10:39:11 2020
3,2,1,gracew0709 (succinyl choline),Re,Sat May 30 02:36:52 2020
11,6,5,Savior09 (Sakana Mazui),[問卦] 美國是不是說話越來越沒份量了?,Sat May 30 00:53:23 2020
2,1,1,SammySosa (我沒用禁藥),[新聞] 就業協助遭疑排擠中高齡 勞動部：都積極,Sat May 30 02:58:14 2020
0,3,-3,ti1990 (hohoho),[問卦] 半夜頭痛怎辦?,Sat May 30 03:42:30 2020
7,3,4,john22088 (銅鑼灣扛報紙),[問卦] 加油講電話到底為什麼會爆炸?,Sat May 30 09:33:10 2020
3,2,1,Hyver (喝杯開水說說話),[問卦] 文蛤想加辣,Sat May 30 09:58:36 2020
3,6,-3,syearth (sysearth),[問卦] 二二八 484跟美國黑人暴動差不多嗎?,Sat May 30 02:40:47 2020
5,0,5,ME13 (小鳥),[問卦] 金城武發過早安圖嗎？,Sat May 30 07:59:25 2020
3,6,-3,secretfly (☠鬼滅· 之喵喵),Re,Sat May 30 09:58:54 2020
10,1,9,ytkuang (就是那個光),[新聞] 「您吃肉我吸油煙」BBQ名店判搬離社區,Sat May 30 10:51:10 2020
5,1,4,eddisontw (沙丘),"[爆卦] 巴西確診人數達到444,444",Sat May 30 01:13:05 2020
10,0,10,e741000 (複利葉。腹便。幫浦拉絲),[問卦] 要開ww3了嗎,Sat May 30 07:17:44 2020
10,4,6,XXXXOAY (台中金城武),[問卦] 解放軍實力會不會跟中國武術一樣？,Sat May 30 09:43:01 2020
2,0,2,kinjk01 (小白),[問卦] 學校越貴品質越好？,Sat May 30 01:55:22 2020
7,2,5,chosenone (獲選者),Re,Sat May 30 07:30:24 2020
1,0,1,sanshin (三振),Re,Sat May 30 11:05:47 2020
11,6,5,DaGoDa (大哥大),[問卦] 台南沒有捷運為何是直轄市？,Sat May 30 10:07:45 2020
2,0,2,JyumonjiKaho (十文字かほ),[新聞] ICC同意 象牙海岸前強人巴波有條件離開比,Sat May 30 07:53:49 2020
5,1,4,zoeforce (呼呼呼嘩哈哈哈),Re,Sat May 30 07:52:02 2020
7,3,4,mongi (大體老屍),[問卦] 單吃鍋底不點菜可以嗎,Sat May 30 10:13:01 2020
3,2,1,PaulDavis (Paul Davis),[爆卦] NBA 7月31日 重新開賽,Sat May 30 03:25:07 2020
219,40,179,tenching (佳釀),[問卦] 一直被嗆台灣好打 該怎麼嗆回,Sat May 30 08:46:17 2020
16,2,14,jason851124 (YeeeEX),[問卦] 你們還背的出那些唐詩?,Sat May 30 10:56:58 2020
169,49,120,,,
10,6,4,haydenhhh (你才臭肥宅),[問卦] 我今天的早餐,Sat May 30 07:14:56 2020
16,2,14,bluebluelan (白魚挺粗強貝柱連根立),[問卦] 香港變成中國的一部份 港式燒臘會消失嗎?,Sat May 30 10:09:17 2020
9,1,8,badjye911 (阿三),[問卦] 價值觀不同在一起好像滿痛苦的？,Sat May 30 10:21:26 2020
5,4,1,oz5566 (威廉。霍恩索倫),Re,Sat May 30 10:00:47 2020
25,1,24,wwwaa1217 (Rwei),[新聞] SpaceX火箭「星艦」測試失敗 原型機爆炸,Sat May 30 10:07:28 2020
2,1,1,A6 (短ID真好),[問卦] 有沒有美國手語的八卦,Sat May 30 04:12:11 2020
8,18,-10,tsukiji (大司壽),[新聞] 支持通姦除罪！美女名醫：關得住男人生,Sat May 30 07:55:52 2020
8,0,8,taiwanesgoi (taiwanesgoi),[問卦] 孤男寡女共處一室有可能只吃蛋撻配奶茶,Sat May 30 02:49:42 2020
1,0,1,CuLiZn5566 (同理心5566),Re,Sat May 30 04:30:42 2020
15,1,14,ccrlovesuck (大奶頭),Fw,Sat May 30 10:21:48 2020
3,1,2,Paravion (ElonMusk),[問卦] 已經整晚沒睡了要睡嗎,Sat May 30 08:48:59 2020
24,8,16,Dinenger (低能兒),[問卦] 練太壯真的沒有比較強啊,Sat May 30 01:18:56 2020
11,7,4,yuponkimo (皇甫尊),[問卦] 有沒有台大碩班備取進度的卦,Sat May 30 09:17:04 2020
730,14,716,cowbay5566 (靠北5566),[爆卦] 美國要退出WHO啦,Sat May 30 03:07:45 2020
150,19,131,SkiCule (Manto),[爆卦] 美國決定離開WHO了,Sat May 30 03:06:07 2020
0,0,0,askw68666 (奶茶蛤蜊戚風),[問卦] 台灣人也能喊乳滑嗎,Sat May 30 11:04:39 2020
6,3,3,ArimuraChika (有村千佳),[問卦] 機車行老闆說確定要修才拆引擎檢查?,Sat May 30 03:20:55 2020
1,1,0,asdfg012345 (Vicious circle),[問卦] 工具人死活關我們屁事☺,Sat May 30 09:58:01 2020
3,2,1,mefifthfloor (新莊王小姐),[問卦] 悲憤！！LINE搖一搖功能消失了¤,Sat May 30 07:04:51 2020
18,4,14,EBVirus (洨洨積極哥),[問卦] 林逸欣為什麼沒有爆紅阿?,Sat May 30 03:01:05 2020
4,11,-7,dlevel (府城中西里菜),[問卦] 早餐店不請年輕妹是不是等著倒閉,Sat May 30 07:34:31 2020
0,0,0,akuan413 (...),[問卦] 通姦罪被關的人可以要求國家賠償嗎？,Sat May 30 11:10:39 2020
5,1,4,Kimmy (Kimi),[問卦] 為什麼只要是三國的女生都是sr以上?,Sat May 30 09:52:55 2020
10,11,-1,pitalvlu (pital),[新聞] 陸駐美使館：內政不容外來干涉 將採必要,Sat May 30 09:02:28 2020
1,0,1,theophany (太太~我喜歡妳啊啊~),Re,Sat May 30 01:59:01 2020
4,1,3,hayate232 (CY),[問卦] 為什麼這部ASMR拍起來這麼色情阿,Sat May 30 10:50:55 2020
21,3,18,assassinASHE (幹古專用帳號),Re,Sat May 30 02:50:05 2020
23,2,21,sharonest (同樣的星空),[問卦] 麻雀有可能從冷氣管線鑽進屋內嗎？,Sat May 30 07:54:59 2020
159,0,159,higashi (哇哈哈),[問卦] 川普總統召開針對中國的新聞發布會,Sat May 30 02:10:18 2020
75,42,33,cjol (勤樸),[新聞] 《經濟學人》：愈來愈可能試探「武力犯台,Sat May 30 09:26:21 2020
0,0,0,luckyalbert (幸運知音),Re,Sat May 30 02:46:43 2020
5,4,1,rei196 (棉花糖),[問卦] 任天堂會後悔砍台任留港任嗎？,Sat May 30 07:04:01 2020
8,0,8,xheath (heath),Re,Sat May 30 03:57:02 2020
27,3,24,leocean9816 (阿光),[新聞] 澳洲學生支持香港民運 被勒令停學,Sat May 30 05:24:16 2020
15,2,13,ArimuraChika (有村千佳),[問卦] 通姦除罪化炮友是不是就合理化呃?,Sat May 30 03:09:42 2020
8,1,7,trolleybus99 (不要問),[問卦] 美國為啥疫情控制不住？,Sat May 30 00:54:29 2020
9,5,4,PaulDavis (Paul Davis),[問卦] 林書豪是不是又要對川普崩潰了?,Sat May 30 03:05:31 2020
7,4,3,bamama56 (bamama),[問卦]  紅紅青春敲壓敲 自己的歌唱呀唱 愛要愛,Sat May 30 08:48:33 2020
12,6,6,ZaneTrout (大谷神鱒),[問卦] 周杰倫最經典的歌是哪一首?,Sat May 30 02:27:08 2020
11,1,10,h58hfaac (進擊的魯魯蛇),[問卦] 玄彬老了484現在的庹宗華？,Sat May 30 09:26:07 2020
3,0,3,david3809 (霜月薰),[問卦] 震撼彈！夏天已經來了嗎？？？,Sat May 30 09:07:20 2020
31,3,28,lauwei (lauwei),[問卦] 二少奶奶說我有才華喜歡我？,Sat May 30 10:09:36 2020
10,4,6,posen2012 (posen),[問卦] 臺灣為啥不研發閃電風暴？,Sat May 30 00:46:11 2020
3,0,3,lanjack (傳說中的草食熊),[問卦] 所以對於NTR是不是以後可以正大光明？,Sat May 30 01:03:02 2020
5,1,4,sleeeve (赴美留學的日子...),[問卦] 中共算是一人專制嗎?,Sat May 30 10:07:40 2020
13,3,10,sleepyuan (文源),[問卦] 台灣能接上香港成為國際金融中心嗎?,Sat May 30 10:47:58 2020
13,1,12,PUTAIR (放空),[爆卦] 台北松智路莊敬路發生嚴重車禍,Sat May 30 10:53:10 2020
3,1,2,HenryLin123 (HenryLin123),Re,Sat May 30 09:15:38 2020
48,14,34,sunbysea (忠言逆耳良藥苦口),[新聞] 班農向蔡英文喊話：這是台灣的時刻！,Sat May 30 09:11:41 2020
31,7,24,HappyDiD (開心的動一動),[問卦] 門牙裂了怎麼辦啊？,Sat May 30 03:16:29 2020
10,4,6,sawaman (楊雨),[問卦] 有適合60歲長輩的打工嗎,Sat May 30 10:39:01 2020
0,0,0,sharkpops (T-Rex),[問卦] M 的滿福堡加蛋 對決路易莎 瑪芬堡加蛋 ,Sat May 30 11:02:40 2020
5,2,3,IamCuteGirl (CuteGirl5566),Re,Sat May 30 01:18:47 2020
4,0,4,Disney (迪士尼),Re,Sat May 30 00:53:40 2020
40,17,23,bertkuan (GRE),[問卦] 以後中國的傳染病 誰來通知美國?,Sat May 30 04:32:41 2020
5,8,-3,sanae0307 (防空棲姬人柱力),[問卦] 現在是越不懂越大聲的八卦,Sat May 30 04:29:35 2020
3,2,1,redDest (☺肛門廔管陣線☺),[問卦] 凱留哪裡凱？,Sat May 30 00:48:00 2020
33,2,31,Bill8x1229 (20分鐘了還是想不到),[問卦] 哪牌啤酒比較推薦？,Sat May 30 05:00:13 2020
33,0,33,PaulAllen2 (kevin),[爆卦] 巴西今日武漢肺炎爆增26354例全球破600萬,Sat May 30 06:32:40 2020
3,0,3,Kakehiko (用localizer晾衣服),[問卦] AF是哪裡啊？,Sat May 30 10:38:13 2020
12,3,9,zrct5566 (美麗又殘酷的世界),[問卦] 屏東沒有墾丁是不是根本沒人會去,Sat May 30 10:42:30 2020
4,5,-1,a240daniel (水水可以獲得嶄新的粉嫩/),[問卦] 肥宅都是什ㄇ時候覺醒腐眼ㄉ？ ★,Sat May 30 01:57:57 2020
34,6,28,kuro (垃圾不分藍綠),[新聞] BBC：英國幫助香港人只是做做樣子,Sat May 30 06:57:38 2020
5,0,5,bloodsweat (痛苦肥宅),Re,Sat May 30 01:45:20 2020
25,1,24,pcappuccino (cappuccino(天龍廚神)),Re,Sat May 30 06:59:07 2020
9,1,8,Paravion (ElonMusk),Re,Sat May 30 04:48:58 2020
5,1,4,zaku2015 (漂流木),Re,Sat May 30 09:01:38 2020
8,4,4,czqs2000 (青山),[新聞] 路易斯維爾抗議中7人被開槍擊中,Sat May 30 01:35:36 2020
13,10,3,kiddking (孩子王),[問卦] 處罰與未成年性交是不是也違憲啊？,Sat May 30 08:46:18 2020
8,7,1,TAMASABUROU (玉三郎),[問卦] 中國會不會買通好朋友國家給香港特殊地位,Sat May 30 06:05:18 2020
15,3,12,nocturne ( ),[問卦] 排骨飯100算貴嗎,Sat May 30 00:59:37 2020
44,8,36,twim1368 (Yo),[問卦] 你重視的人不把你當好友該怎麼調適,Sat May 30 04:37:59 2020
5,4,1,hoanbeh (初入江湖淨添堵),"[問卦] 退出WHO會不會成為美國的""蘇伊士時刻""？",Sat May 30 10:55:28 2020
6,3,3,kons (kons),Re,Sat May 30 06:31:49 2020
1,2,-1,wlo3176844 (大可),Re,Sat May 30 04:34:45 2020
1,0,1,smallGGgirl (ㄏㄏ),Re,Sat May 30 09:41:45 2020
103,7,96,zxc17893 (八千代代木村拓哉),[問卦] 那些國家會跟進離開WHO?,Sat May 30 03:14:41 2020
9,0,9,fraternity (duhamanity可以原諒他阿1),[問卦] 2018年以前，講到又老又窮會聯想到什麼,Sat May 30 04:35:23 2020
15,6,9,Thozus (Thozus),Re,Sat May 30 09:44:55 2020
9,3,6,kasumi5566 (霞),[問卦] 精液會那麼黏稠是不是量子糾纏,Sat May 30 08:58:09 2020
29,0,29,XXXXHAY (過氣ID),Re,Sat May 30 01:47:48 2020
5,2,3,Lalef (Lalef),Re,Sat May 30 02:24:15 2020
1,0,1,chen5566 (文心),Re,Sat May 30 10:55:52 2020
4,1,3,HuangJC (吹笛牧童),Re,Sat May 30 01:03:14 2020
2,1,1,lomo013076 (Lody),[問卦] 請問喜歡井手上漠算甲嗎？,Sat May 30 10:40:52 2020
21,5,16,rock30106 (摩卡我婆),[問卦] 通姦除罪化的結果,Sat May 30 02:10:51 2020
3,0,3,TS28 (nlnlOUO),[問卦] 有沒有陽明山繡球花的八卦？,Sat May 30 10:08:00 2020
0,0,0,zntozteent (百香綠加椰果),[問卦] 結局是什摸呢？,Sat May 30 04:59:37 2020
78,6,72,royroy666 (老鼠),[問卦] 美國阿爸都退出WHO了 台灣還要進嗎？,Sat May 30 07:57:02 2020
1,0,1,seuil (               ),Re,Sat May 30 09:23:54 2020
13,8,5,abc12812 (),[問卦] 通姦是男生多還是女生多?,Sat May 30 03:48:00 2020
15,6,9,takuminauki (史迪格里茲粉),[問卦] 張鈞甯的腿是亞洲第一美嗎?,Sat May 30 01:18:11 2020
22,4,18,koei0001 (魯國人),[問卦] 川普選輸了會怎樣?,Sat May 30 10:02:59 2020
3,0,3,meblessme (地球太可怕我要回火星),Fw,Sat May 30 07:02:28 2020
2,1,1,olmtw (olmtw),[新聞] 黎智英投書紐時：港版國安法扼殺言論自由,Sat May 30 08:24:29 2020
8,2,6,taiwanesgoi (taiwanesgoi),[問卦] 我站在人行道上飲豆奶,Sat May 30 06:42:05 2020
2,0,2,ZaneTrout (大谷神鱒),[問卦] 公主有沒有病?,Sat May 30 03:44:06 2020
8,0,8,zzzz8931 (宅男),[問卦] 你媽昨天有流眼淚嗎？,Sat May 30 02:44:05 2020
2,9,-7,hoanbeh (初入江湖淨添堵),Re,Sat May 30 08:16:14 2020
5,2,3,z0953781935 (葛格是大笨蛋>///<),[問卦] 蘿莉修女跟會放電的女國中生要選哪個？,Sat May 30 10:35:52 2020
4,3,1,LaAc (深淵戰士),Re,Sat May 30 08:51:15 2020
4,0,4,a828203 (),[問卦] ROCKY 學會詠春拳會怎樣?,Sat May 30 10:49:07 2020
13,10,3,r1i545we (空姐漢堡堡),[問卦] 去年香港不要反送中在那鬧是否就沒事了？,Sat May 30 09:57:12 2020
4,0,4,Bill8x1229 (20分鐘了還是想不到),[問卦] 睡不著怎麼辦？,Sat May 30 04:50:16 2020
1,0,1,shotholisi (呆れて白目をむく),Re,Sat May 30 02:01:57 2020
4,0,4,nike3508 (QQ),[問卦] 天花板有老鼠怎麼辦喇淦,Sat May 30 02:56:31 2020
7,1,6,yazeroplus (zero),[新聞]火球沖天！新北回收場晚間大火 延燒2工廠,Sat May 30 06:20:37 2020
5,12,-7,z770808 (),[新聞] 推完港版國安法 北京又開「反分裂法」座,Sat May 30 07:09:11 2020
2,3,-1,nocturne ( ),Re,Sat May 30 01:34:29 2020
9,3,6,pupss89177 (asshole young),[問卦] 為什麼我長怎麼帥 卻要掉頭髮,Sat May 30 05:01:48 2020
8,2,6,zxc17893 (八千代代木村拓哉),[新聞] 永和外籍男遭割脖分屍！辦案警回家秒昏：,Sat May 30 02:05:20 2020
7,2,5,Slupi (Slupi),[問卦] 把情緒宣洩在同事身上,Sat May 30 04:56:07 2020
4,1,3,Mark0529 (神),Re,Sat May 30 09:22:21 2020
3,1,2,ocean92 (海),[問卦] 該怎麼關心在香港金融業上班的朋友,Sat May 30 08:32:59 2020
3,0,3,AngryYouth (森寶 420friendly),[問卦] 吃到不好吃的宵夜要怎麼平復心情,Sat May 30 04:48:09 2020
4,1,3,clubbox (史上最強7788 ),[問卦] 劍潭站旁橋墩是吃夜市的秘密基地嗎,Sat May 30 01:49:23 2020
1,4,-3,e741000 (複利葉。腹便。幫浦拉絲),Re,Sat May 30 09:19:30 2020
114,49,65,XDDDDDDDDDD (我笑他人看不穿),[新聞] 蔡英文論文風波》彭文正怒告誹謗　發言,Sat May 30 08:24:53 2020
38,3,35,AngryYouth (森寶 420friendly),[問卦] 這個矯正大概要多久的卦,Sat May 30 04:38:27 2020
0,1,-1,ketter (挖西林老背),[問卦] 有沒有當美國總統的八卦,Sat May 30 09:56:37 2020
14,3,11,lcw33242976 (逆天改命脫非入歐),[問卦] 嘔嘔嘔嘔嘔，到底誰會吃苦瓜？,Sat May 30 03:24:21 2020
1,0,1,seabox (盒盒),[公告] 八卦板板規(2020.04.21),Tue Apr 21 00:01:01 2020
6,1,5,pennyleo (今朝有酒今朝醉),[問卦] 一場海峽兩岸惡戰，眼看迫在眉捷,Sat May 30 09:40:03 2020
10,3,7,www26235673 (Lalala),[問卦] 習包子是不是內鬥內行外鬥外行阿？,Sat May 30 07:47:12 2020
0,9,-9,chamge7788 (經濟王7887),[問卦] 手機效能與售價cp值最高的是不是xzp,Sat May 30 08:48:07 2020
10,1,9,Kitakami (公主連結特約工讀生),[問卦] 這年頭，會開手排車的人多嗎?,Sat May 30 10:21:25 2020
14,4,10,LeonardoChen (LeonardoChen),[問卦] 美國這麼亂為什麼全世界人材都想去？,Sat May 30 01:55:48 2020
1,0,1,gay731 (G少),Re,Sat May 30 09:32:15 2020
10,4,6,ann141414 (胖呆),[新聞] 【國軍防疫當兒戲1】敦睦艦隊才傳染武肺 ,Sat May 30 10:18:35 2020
4,10,-6,zzyyxx77 (討噓大師77),[新聞] 真正的挑戰來臨！唐綺陽曝難題已逼到眼,Sat May 30 07:19:25 2020
38,2,36,iou861007 (中壢金城武),[問卦] 有人知道這是幹嘛用的嗎,Sat May 30 08:04:42 2020
16,4,12,typeklng (  ),[問卦] twitter比facebook好用,Sat May 30 10:43:26 2020
11,6,5,Tapqou (三三三),[問卦] 台男的求女焦慮症,Sat May 30 06:30:48 2020
7,5,2,neqq236 (Since5566),[問卦] 有人可以陪我打遊戲嗎 lol版被捅,Sat May 30 10:49:09 2020
2,5,-3,markban (馬克白),Re,Sat May 30 01:02:27 2020
78,5,73,Hopesmaple (),[新聞] 川普宣布「終止與WHO關係」將取消香港特,Sat May 30 08:49:26 2020
13,1,12,hn9480412 (ilinker),[新聞] 用看的可估價？ 機車行頻遭疑修車費高,Sat May 30 02:50:45 2020
2,0,2,lianpig5566 (家庭教師殺手里包恩),[問卦] 電動公車是未來趨勢嗎,Sat May 30 09:50:06 2020
2,1,1,ipapa (),[問卦] 有沒有養犬兄妹的八卦?,Sat May 30 09:31:28 2020
23,44,-21,staedtler (鐵甲武士),[新聞] 川普擬驅逐部分陸生 趙立堅：美國要食言,Sat May 30 08:26:29 2020
1,3,-2,kria5304 (XenoMegaREENovaSaga),Re,Sat May 30 09:33:15 2020
6,2,4,bmwg8 (G8),[問卦] 竹北為什麼不蓋輕軌啊,Sat May 30 00:49:51 2020
2,0,2,R101 (索尼大法好),[問卦] 要一起把珠寶竊盜犯抓起來嗎,Sat May 30 10:31:18 2020
1,0,1,xzcb2008 (卍情色日本喵喵卍),Re,Sat May 30 09:53:27 2020
6,2,4,MCSTRADALE (MaseratiMCstradale),[新聞] 重磅！川普宣布取消香港特殊待遇,Sat May 30 04:01:29 2020
5,7,-2,wwwaa1217 (Rwei),[問卦] 早點名,Sat May 30 09:50:11 2020
32,4,28,Natsutaka (夏宇),[爆卦] 不要再騙性平也關心男人了,Sat May 30 00:58:16 2020
4,0,4,XXXXLINDA (1111),[問卦] 唉 半夜八卦不是一堆社會新聞 好高興,Sat May 30 02:56:07 2020
6,0,6,hposuperman (銀絲卷),[問卦] 經血跟包皮垢哪個比較噁？,Sat May 30 10:15:31 2020
10,2,8,suntw (冬瓜),[新聞] 辦案中致非裔男子死亡 美明州警官被控謀,Sat May 30 09:35:03 2020
5,0,5,jackwula9211 (黑嘿潶默黜黯黛黧黳黨黴),[問卦] 有沒有多情城市預告片摔活鳥的八卦,Sat May 30 00:50:21 2020
0,0,0,c52chungyuny (intel inside),[問卦] 通姦除罪vs. 離婚法定冷靜期  哪個重要,Sat May 30 11:03:30 2020
4,0,4,shala (沙羅是轉換後的文字檔打m),Re,Sat May 30 07:02:36 2020
1,4,-3,sh981215 (世界の副委員長？！？！5),[問卦] 東尼是通姦的受害者嗎？,Sat May 30 01:35:49 2020
11,2,9,LIN9 (LIN9),[新聞] 習訪日添變數？ 陸：盼日方創造良好氛圍,Sat May 30 07:10:11 2020
85,11,74,CHL98 (CHL),[新聞] 北漂2青年求租凶宅！「多兇都沒關係」,Sat May 30 01:45:21 2020
4,8,-4,BIA (必亞),"[問卦] 台灣沒加入WHO,，是不是先知？",Sat May 30 07:17:28 2020
9,0,9,stockeye (stockeye),[問卦] 6月6日周6，會不會下雨???,Sat May 30 08:38:03 2020
6,0,6,richjf (richArt),[新聞] 援港法制化 陸委會將修港澳條例細則,Sat May 30 06:11:19 2020
4,11,-7,shirokase (氧化鋼刺),[問卦] 用伴侶賺錢跟滿足被寢取性癖的時代來了,Sat May 30 07:10:50 2020
7,1,6,addison123 (鄉下小鮮肉),[問卦] 台灣有什麼本錢搞募兵？,Sat May 30 09:12:04 2020
14,2,12,XDDDpupu5566 (XDpu56家族),[問卦] 香港要怎麼畫三角形？,Sat May 30 05:04:24 2020
15,2,13,tony51501 (x-ray),[問卦] 這是什麼鳥的蛋,Sat May 30 08:10:59 2020
10,4,6,Phoenix723 (操場旁的含羞草),[問卦] 「樂」要怎麼念,Sat May 30 09:48:11 2020
5,5,0,gk1329 (),[問卦] 鬼島是不是慢慢朝零犯罪進步,Sat May 30 09:17:18 2020
22,0,22,ll6a (老成a~),[問卦] 大家覺得川普會把給世衛的錢轉到哪個組,Sat May 30 06:09:33 2020
16,2,14,herbert0716 ((っ・ω・)っ),[問卦] 梅艷芳的胸部到底是不是真的???,Sat May 30 08:53:29 2020
1,3,-2,brucielu95 (可撥農校淪落人),[問卦] 想你的日子如何砌成孤單房子？,Sat May 30 02:53:55 2020
50,2,48,owo0204 (owo0204),[問卦] 為什麼罵習近平=辱華?,Sat May 30 09:38:18 2020
14,4,10,e741000 (複利葉。腹便。幫浦拉絲),[問卦] 根據所得稅開放配偶數量怎樣,Sat May 30 07:43:16 2020
20,21,-1,anandada (安安！大大！),[新聞]蔣萬安逼問振興券 嗆爆蘇揆,Sat May 30 08:34:38 2020
11,2,9,h1300285 (密斯特羊),[新聞] 【新國會2.0】水牛伯挺過耍官威、酬庸風,Sat May 30 10:50:19 2020
75,5,70,mouse0720 (凜月銘心),[新聞] 他家裡抓到白蟑螂 行家秒出價20萬,Sat May 30 10:38:02 2020
3,0,3,takashi01 (廢文小王子),[問卦] 凶宅凶宅的不是不迷信嗎？,Sat May 30 02:11:27 2020
5,3,2,deepdish (Keep The Faith),[問卦] 有沒有 SUGA 閔玧其的八卦？,Sat May 30 07:30:08 2020
162,32,130,ikottong (ikottong),[爆卦]驚見徐熙媛於香港文化演藝界支持國安法聯署名單,Sat May 30 01:23:31 2020
8,2,6,y7moremore (WN),[問卦] 一款線上遊戲的崩落,Sat May 30 10:25:54 2020
5,0,5,Beanoodle (津崎似超人平匡先生),Re,Sat May 30 04:07:10 2020
0,2,-2,Cory5566 (科理5566),[問卦] 麥當勞的雪碧味道變了?,Sat May 30 00:59:33 2020
9,0,9,ryanchang03 (Ryan),Re,Sat May 30 01:33:25 2020
2,20,-18,Warnerting (天下一大五郎),[新聞] 武備為輔 共軍將領透露和為貴,Sat May 30 07:16:04 2020
0,0,0,abcgo (真冷的冬天),[問卦] 有沒有靈魂乾涸的八卦,Sat May 30 09:49:54 2020
20,2,18,Chen334 (古先生),[問卦] 越看八卦越否定人生的八卦,Sat May 30 08:53:59 2020
6,2,4,Nagato (長門),[問卦] 要丟了,Sat May 30 08:44:33 2020
20,4,16,ashin0709 (),[新聞] 成龍率2600人連署挺「港版國安法」　大咖,Sat May 30 10:53:09 2020
1,4,-3,homerun2005 (ほめる),[問卦] 會找支那人一起玩遊戲嗎？,Sat May 30 09:12:46 2020
1,0,1,ifulita (唯我成幸),Re,Sat May 30 02:11:02 2020
2,9,-7,leocean9816 (阿光),[問卦] 第一次射屏給九面莎莎的人是在想什麼？,Sat May 30 01:52:48 2020
6,0,6,tengy (白色世界),[新聞],Sat May 30 09:54:02 2020
15,5,10,liu2007 (薯),[問卦] 川普退跟蔣光頭退的差別？,Sat May 30 10:27:10 2020
13,21,-8,safelyfuck (),[問卦] 整天徘徊肺炎板自慰國威的都那些人,Sat May 30 01:41:26 2020
2,0,2,AKAgg (突き刺不準),[問卦] 捐血中心的帳號登不進去啦,Sat May 30 01:14:29 2020
15,4,11,bear26 (熊二六),[問卦] 如果打仗了 進入戒嚴各位ok嗎？,Sat May 30 03:59:29 2020
15,0,15,SpinozaPi (羅森),[問卦] 關於switch現況,Sat May 30 08:42:57 2020
7,2,5,XXXXHAY (過氣ID),[問卦] 現實中八頭身以上的人是腦太小嗎,Sat May 30 01:36:12 2020
22,8,14,jamo (hi),[問卦] 通姦除罪化最爽的人,Sat May 30 00:51:58 2020
33,5,28,obey1110 (obey),[新聞] 與陳時中拚場？「枋寮漁?節」移師台北花,Sat May 30 08:18:28 2020
2,1,1,JimOBrien (family man),[新聞] 黃金雨、爆炸樹綻放！中市街頭搖曳添浪漫,Sat May 30 10:32:44 2020
2,0,2,KirimaSyaro (男孩兒要對自己好一點),Re,Sat May 30 09:22:18 2020
0,0,0,Rapacious (八分音),Re,Sat May 30 06:20:26 2020
5,0,5,godog3000 (gogodog思這樣不忍割愛),[問卦] 要創造自己被利用的價值,Sat May 30 04:58:08 2020
6,3,3,ntuicome666 (白金大學生),[問卦] 嘴破的時候大家都怎麼刷牙,Sat May 30 01:34:24 2020
1,0,1,STAV72 (刁民黨黨務主委),Re,Sat May 30 10:38:11 2020
0,0,0,WorkinChina (WIC),[新聞] 蔡英文「撐港」!國台辦:插手香港事務自,Sat May 30 11:06:52 2020
8,1,7,kimisawa (楊回血了。),Re,Sat May 30 00:46:47 2020
5,0,5,mnssddxs (justin123),[問卦] 是不是很多人不知道什麼叫零用錢,Sat May 30 01:01:05 2020
2,0,2,AngryYouth (森寶 420friendly),Re,Sat May 30 04:59:20 2020
6,1,5,obdv (真☆母★教右護法),[新聞] 火爆！中華電信股東「互嗆」圍人牆維持,Sat May 30 10:42:10 2020
136,38,98,DarkHolbach (黑道公子讓你變失業魯蛇),[問卦] 為什麼有些人覺得通姦除罪就是可以隨便,Sat May 30 07:19:51 2020
1,0,1,lusanova (建立新典範),Re,Sat May 30 10:57:52 2020
3,3,0,qqq87112 (小Q),[新聞] 梅雨下不停 菜價漲聲響起,Sat May 30 07:53:45 2020
0,0,0,cycling (一直暴雷一直爽),[問卦] 低卡熱門-妳是怎麼懷孕的,Sat May 30 11:03:57 2020
4,0,4,G888888 (廢文產生器),[問卦] 做股票的是不是都很樂觀啊？,Sat May 30 02:36:04 2020
3,1,2,deepdish (Keep The Faith),[新聞] 女星被控拉皮條、監禁！受害者淚訴離譜過,Sat May 30 02:28:53 2020
9,0,9,aOwOa (解剖青蛙的飛鼠),[問卦] 臺北是不是沒有一大塊空地的夜市,Sat May 30 01:26:49 2020
4,3,1,fawangching (小資男),[問卦] 正妹也會大便 會覺得有點掃興嗎？,Sat May 30 10:53:16 2020
3,1,2,sluttysayage (我不會 被打倒的),[問卦] 現在在高雄天氣適合穿什麼？吊嘎會太涼嗎,Sat May 30 09:56:23 2020
30,3,27,L1ON (我是獅子~(ﾉﾟ▽ﾟ)ﾉ♪),Re,Sat May 30 03:09:30 2020
47,9,38,Wei55667788 (桃乃木控),[問卦] 房東是不是最爽職業啊,Sat May 30 01:05:59 2020
10,5,5,znck (風月),[新聞] 香港資金人才出走 蘇揆：台灣歡迎並做好,Sat May 30 01:07:17 2020
0,0,0,Behind4 (背後4),Re,Sat May 30 04:04:04 2020
4,0,4,kusowan (你感受一下),Re,Sat May 30 03:19:11 2020
5,1,4,truffaut (Bon Vivant),[新聞] 最多5折！NIKE官網突襲「快閃特賣」高筒A,Sat May 30 04:54:55 2020
0,1,-1,markban (馬克白),Re,Sat May 30 10:09:58 2020
4,0,4,higashi (哇哈哈),[問卦] 帳戶裡還有港幣的人現在在想什麼？,Sat May 30 09:46:22 2020
1,0,1,markban (馬克白),Re,Sat May 30 01:48:16 2020
0,0,0,ig49999 (QQ),[問卦] 女生這麼喜歡吃兩餐??,Sat May 30 11:09:04 2020
1,0,1,oooo (法性本寂隨緣轉),Re,Sat May 30 10:59:58 2020
3,0,3,naruisi (娜瑞絲),[問卦] 某些老師說話是不是白噪音等級啊,Sat May 30 01:00:28 2020
2,1,1,Golf19 (19Golf),Re,Sat May 30 10:26:16 2020
6,2,4,Tapqou (三三三),[問卦] 一夫多妻或一妻多夫，8+9會滅亡嗎?,Sat May 30 08:26:43 2020
2,2,0,johanLarson (Rent),Re,Sat May 30 00:58:59 2020
4,2,2,Huangw (wei),Re,Sat May 30 06:47:53 2020
25,3,22,DOOHDLIHC (董事長),[問卦] 館長打得贏太極掌門人馬保國嗎,Sat May 30 07:37:10 2020
10,1,9,ocean0817 (氐都狼),[爆卦] 震,Sat May 30 06:59:19 2020
5,2,3,deepdish (Keep The Faith),[問卦] 有沒有 Mengyan Zhu 孟衍竹的八卦？,Sat May 30 06:02:27 2020
16,27,-11,LoveMakeLove (愛がすべて),[新聞] 課征肥胖稅 劉伯恩建議先從｢吃到飽｣開,Sat May 30 08:09:39 2020
10,5,5,PrinceKanto (生田絵梨花は俺の嫁),Re,Sat May 30 01:02:03 2020
7,4,3,a828203 (),[新聞] 反分裂法15週年 學者：北京棍棒胡蘿蔔齊,Sat May 30 07:14:30 2020
2,0,2,LeonardoChen (LeonardoChen),Re,Sat May 30 00:54:08 2020
7,0,7,skywould (賽普勒斯),[問卦] 真的有永遠不會壞的電燈嗎？,Sat May 30 10:41:31 2020
16,0,16,douglasjs (帥到吐),[問卦] 有沒有美國水很難喝的八卦？,Sat May 30 07:50:27 2020
2,1,1,qqq87112 (小Q),[問卦] 大股東離開公司要注意什麼,Sat May 30 08:00:56 2020
18,0,18,shiauji (Transitory),[問卦] 大馬最讓各位有印象的是誰？,Sat May 30 10:47:20 2020
6,20,-14,nasha2 (蝴蝶效應 六度分隔理論),[問卦] 通姦除罪後 下輩子投胎破碎家庭機率變高,Sat May 30 03:51:40 2020
7,3,4,pinebox (pinebox),[新聞] Minneapolis 暴動的倒楣鬼,Sat May 30 03:43:05 2020
5,2,3,than09138 (tony wu),[問卦] 月底到了只剩900元何解？,Sat May 30 01:02:54 2020
8,2,6,nobody0303 (),[問卦] 同事剛看完一卷錄影帶 突然表情變了,Sat May 30 01:20:03 2020
5,3,2,mefifthfloor (新莊王小姐),[問卦] 有沒有遇過在速食店厚臉皮佔位,Sat May 30 09:11:11 2020
3,1,2,sdudu (眼中還有火焰),Re,Sat May 30 01:05:04 2020
4,0,4,minipig1127 (不錯的開始~),[問卦] 中美黑警哪家強?,Sat May 30 09:53:37 2020
1,0,1,fcugeo (fcugeo1746),[問卦] 現在的課本是怎麼看待全球化組織的,Sat May 30 07:14:44 2020
6,0,6,sunine6488 (aki),Re,Sat May 30 01:35:28 2020
8,0,8,yingjeou (英九),Re,Sat May 30 01:36:42 2020
2,2,0,jack5u06d93 (jackboss),[問卦] 現在當兵會有漂亮學姊嗎？,Sat May 30 10:01:09 2020
